1111111111111111111111111111111111
1E0000000000000C000M0C0000000000M1
10100101001000001010010M0000010101
1010M1001010101M001001000M00010101
1P00000M0C00C00000000000000M0000C1
1111111111111111111111111111111111