11111111111111111111111
1C000000000000100000001
1000000000000000000C001
11011100M0111100C000001
1000000000111100000M001
111111110M0111000000001
100000000000010000P0001
10C00000000001000000001
11011100M0111100000C001
10000E00000C00000000001
11111111111111111111111