11111111111
11110C01111
11110001111
11110M01111
11110001111
10000000001
1C0M0P0M0E1
10000000001
11110M01111
11110001111
11110E01111
11111111111